M                                                         L    L                                                                                                                                    P                         LL                                n                       n             N               n                                      M
M                                     L                  ZYW   Y                                                                          Y   Y      ZW   PP     PP                      Y         ZW                         ZW                                                                                             N         n                     M
M                                     ZXW       ZW                                                                                ZXW               P   P ZYXYXWPZW   P                                   Y             Y                PP                                                                      n                                           M
M                                                                   Y              L             Y      L PPPPPP                                    Y   Y       Y     Y                       Y                   Y                      ZW                                                                                                    n             M
M                     L      ZYW                                P         Y        ZW     ZXW      P    ZYXYXXYW              ZW             L                                          Y             Y                                         PL     L              n                                 n                                                    M
M                    ZXW              PPP        L            ZYW                                  Y                     L                  ZYW                                    L                                                    ZW   PPPYW     Y                                                         N                                           M
M            ZYW                      ZXW      ZYXW                          ZY                                         ZXW                                  LP                   ZXW                                                        ZXX                                           n                               n           N                     M
M                                P      L               P LP                      P      LLL          PP  L  Y   Y                 LLL       L            Y  ZW   L            L        LPPPL      LLL      LP          L                    L                LLLLLLLL                                                                                       M
SSSSSSSSSSSSSSSSSSSSS           ZW    SSSS              SSSS                      S     SSSSS         SSSSSS                      SSSSS     SSS      Y           SS     S      S       SSSSSS      SSS      SSSS   S    S       SS           SSSSS         SSSSSSSSSSSSSSSSSSSSSSSSSSSSSSSSSSSSSSSSSSSSSSSSSSSSSSSSSS   SSSSSSSSSSSSSSSSSSSSSSSSSSSSSSSSSSSSSS