M                                                        LL                                                                                                  LLL                                                                                                n          LL           n             N               n                                      M
M                                                        BBB                                                                                                 BBB                                                                     B              BBB                   BBBB                                               N         n                     M
M                                               L               BB   L                                  LLLL               BB     BBB                                                                                     LL            B                                                                        n                                           M
M                              L               BB                  BBB             L       LL          BBBBBBB                                      L               L       L           BBB                       L       BBB     B           L            BBB      BB            L       L                                                    n             M
M                     LL      BBB                              P                   BB     BBB                       BB                       L     BBB         P   BB      BB                         L          BBB                          B                       n          BBB      BB            n                                                    M
M                    BBB                BBB                  BBB                                                         L                  BBB                B                   L                  BB                                                                                                        N                                            M
M             BBB                                                           BBB                                         BBB                             BBB                       BBB                      BBB                                                                             n                               n           N                     M
M                       L         P            L                                                     P      PP                        L                                 LL                                                      L                   PPP                                            LL                                                        M
SSSSSSSSSSSSSSSSSSSSSSSSSSSSSSSSSSSSSSSSSSSSSSSSSSS  SSSSSSSSSSSSSSSSSSSSSSSSSSSSSSSSSSSSSSSSSSS    SSSSSSSSSSSSSSSSSSSSSSSSSSSSSSSSSSSSSSSSSSSS  SSSSSSSSSSSSSSSSSSSSSSSSSSSSSSSSSSSSSSSS       SSSSSSSSSSSSSSSSSSSSSSSSSSSSSSSSS       SSSSSSSSSSSSSSSSSSSSSSSSSSSSSSSSSSSSSSSSSSSSSSSSSSSSSSSSSSSSSSSSSSSSSSSSSS   SSSSSSSSSSSSSSSSSSSSSSSSSSSSSSSSSSSSSSSS